0000000000000
0000000000000
0001101111110
0001101111110
0001100000000
0001100000110
0001100000110
0001100000110
0000000000110
0001111110110
0001111110110
0000000000000
0000000000000
